11111111111111111111111111111111111111111111111111
11PC000000000000C00000C000000000000C00000E01111111
11111111111111111111111111111111111111111111111111
