1111111111111111
1111111111111111
1111111111111111
1111111111111111
1111111111111111
1111111111111111
1111111111111111
1111111111111111
1111111111111111
1111111111111111
1111111111111111
1111111111111111
1111111111111111
1111111111111111
1111111111111111
1111111111111111
1111111111111111
1000000000000001
1000000000000E01
100000C0C0000001
1000000000000001
1P00111111111111
1000000000000001
1000000000000001
1111111111111111
