111111111111111
100P000000000C1
1CCCCCCCCCCCCC1
1000CCECCCC0C01
111111111111111
