111111111111111
100P000000000C1
1CCCCC111CCCCC1
1000CC1E1CC0C01
111111111111111
