11111
1PEC1
10001
10111
11111
