11111111111111111111111111111
10000000000000000000000002001
10000000000000000000000000001
1C000000000000000000000000001
10000000000000000000000000001
10000000000000000000000000001
10000000000000000000000000001
10P00000000000000000000000001
1000000000000000000000000C0E1
11111111111111111111111111111
