1111111111
1000000001
1ECCCCCCC1
1CCCCCCCC1
1110011111
1000000001
1000000001
1000000001
1000000001
100000C1P1
1111111111
