11111111111111
1EC00000000001
11100111100001
10200000000001
10000000001011
100000C1PC00C1
11111111111111
