1111111111111111
1111111111111111
1111111111111111
1111111111111111
1111111111111111
1111111111111111
1111111111111111
1111111111111111
1111111111111111
1111111111111111
1111111111111111
1111111111111111
1111111111111111
1111111111111111
1111111111111111
1111111111111111
1111111111111111
1000000000000001
1000000000000E01
1000000000000001
1000000000000001
1P11111111111111
1000000000000001
1000000000000001
1111111111111111
