11111111111111111111
10000000000000000101
1E000000000000000001
10000000000000000001
11100111100000000011
10000000000000000001
10000000000000000011
100000C1PC00000000C1
11111111111111111111
