11111111111111111111111111111111111111111111111111111111
1CCCCCCCCCC1CCCCCCCCCCCCC11CCCCCC1CCCCCC11CCCCCCCCC11C11
1CCCCCC11CC1CC11CCCCC11CC11CCCCCC1CC11CCCCCC1CCCCCC11C11
11111CC11CC111111111C11CC11CC11111CC11CC111111111CC11C11
1CC11CC11CCCCCCCCCCCC11CC11CCCCCCCCC11CCCCCCCCC11CC11C11
1CC11CC1111111111111111CC111111111CC111111111CC11CC11C11
1CCCCCC11CCCCCCCCC11C11CC11CCCCCC1CC11CCCCCCCCC11CCCCC11
1CC111111CC11111CC11C11CC111111CC1CC11CC11CC11111CC11C11
1CCCCCC11CCCCC11CCCCC11CC11CCCCC11CCCCCC11CC1CCCCCC11C11
11111CC11111CC111111C11CC11CC111111111CC11CC1CC111111C11
1CCCCCC11CCCCC11CCCCC11CC11CCCCCCCCCCCCC11CC1CC11CCCCC11
1CC1111111111111CC11C11CC111111111CC111111CC1CC11CC11111
11CCCCCCCCCCCCCCC111C11CC11000111111110011CC1CC111111111
111111111CC1CC111111111CC11001111111110011CC1CCC11111111
1CC111111111CC11CCCCC11CC11111CCC111111111CC111111111011
1CC11CCCCC11CCCCCC11C11CCCCCCCCCC1CCCCCC11CC11CCCCC11011
1CC11CC1CCC11111CC11C111111CC11111CC11CC11CC1CC11CC11111
1CCCCCC11CC1CCCCCC11C11CCCCCC11CCCCC11CC11CCCCC11CCCCC11
111111111CC1CC111111C1111111111CC111111111CC111111111C11
1CC11CCCCCC1CC11CCCCCCCCCCCCCCCCCCCCCCCCCCCCCCC11CCCCC11
1CC11CC11111CC11111111111111111111111111111111111CC11111
1CC11CC11CCCCCCCCC11CCCCCCCCCCCCC1CCCCCCCCCC1CCCCCCCCC11
1CC11CC11CC11111CC11C1111111111CC1CC111111CC1CC111111C11
1CCCCCC11CC1CCCCCC11CCCCCCCCC11CCCCC11CC11CCCCCCCCC11C11
11111CC11CC1CC1111111111111CC111111111CC1111111111111C11
1CCCCCC11CC1CCCCCCCCC11CCCCCC11CCCCC11CCCCCC1CCCCCC11C11
1CC111111CC111111111C11CC111111CC111111111CC1CC11CC11C11
1CCCCCCCCCC1CCCCCCCCC11PECCCC11CCCCCCCCCCCCCCCC11CCCCC11
11111111111111111111111111111111111111111111111111111111
