1111111
1C00101
1001001
10EP001
1111111
