11111111111111111111
10000000000000000101
1ECCCCCCCCCC2CCCCCC1
1CCCCCCCCCCCCCCCCCC1
111001111CCCCCCCCC11
100000000CCCCCCCCCC1
100000000CCCCCCCCC11
100000C1PCCCCCCCCCC1
11111111111111111111
