111111111111111111111111111111111111111111111111111111
100000000000000000000000000000000000000000000000000001
100000000000000000000000000000000000000000000000000001
100000000000000000001111111111001111111111111111111001
100000000000000000111111111100001111111101111111111001
100000000000000011111111110000001111110001111111111001
100000000000001111111111000000001111000001111111111001
100000000000111111111100000000001100000001111111111001
100000000011111111110000000000000000000011111111110001
10000000111111111110000000000P000000001111111111000001
100000011111111110000000000000000000111111111100000001
100001111111111000000000000000000011111111110000000001
100111111111111111111111111111000111111111000000001001
10011111111111111111111111111100111111111100E000111001
100111111111111111111111111111001111111111000011111001
100111111111111111111111111111001111111111001111111001
100000000000000000001111111111001111111111111111111001
100000000000000000001111111111000000000000000000000001
100000000000000000001111111111000000000000000000000001
100000000000000000001111111111000000000000000000000001
1C0000000000000000001111111111000000000000000000000001
100000000000000000000000000000000000000000000000000001
100000000000000000000000000000000000000000000000000001
111111111111111111111111111111111111111111111111111111
