11111111111111111111111111111111111111111111111111111111111
1000000000001111000000111000CCCCCC0001111000000000000000001
100000CCCCCC1111000000111000CCCCCC000111100000000E000000001
10000100000011110000001110000000000000111000000000000000001
1000010000CCCC0000000011100000000000011110000110CCCCC010001
1000010000CCCC000000001110000000000001111000011000000010001
1000000000CCCC000000001110000000000001111000011110111110001
10000000002000000000001110000000000001111000011110111110001
10000000000000000000000000000000000001111000011110111110001
10000000000000000000000000000000000001111000011110111110001
10111111111111111111111111111111100001111000000000000000001
10000000100000000000000000000000000001111000000000000000001
1000011111111111111100000P000000000000111000001000001000001
10000000000000000000000000000000000001111000001000001000001
11111111110111111111111111111111111111111000001111111111111
10000000C000000000000000000000000000000010000010000010CC001
10000000C00000000000000000000000000000001000001000001000001
10000000C000000000CCCCCCCCCCCCCCCCC000001000001000001011111
10000000C00000000000000000000000000000001000001000001000001
11111111111111111111111111111111101111111000001000001111101
11111111111111111111111111111111000111111000001111111000001
11C00000000000010000000000000000010000C11000001000001000001
1100111110000001000000000000011111011111100000100C001000001
1100111110000001000000000000011111011111100000100C001000001
11000000CCCCCCCCCCCCCCCC0000011111011111100000100C001000001
1100111110000001000000000000011111100000000000100C001011101
1100111110000001000000000000011111000001100000100000101C101
11C00000000000010000000000000000000111111000000000000010001
11111111111111111111111111111111111111111111111111111111111
