1111111111111
1000000000001
0111111111111
1111111111111